▓▓▓▓▓▓▓▓▓▓▓▓▓▓▓▓▓▓▓▓▓▓▓▓
▓   ▓                  ▓
▓      ▓               ▓
▓   ▓  ▓               ▓
▓   ▓ ▓▓▓▓    ▓ ▓▓▓    ▓
▓C  ▓ ▓ E▓    ▓ ▓      ▓
▓▓▓ ▓ ▓  ▓    ▓ ▓      ▓
▓   ▓ ▓  ▓▓▓  ▓ ▓      ▓
▓   ▓    ▓    ▓        ▓
▓   ▓    ▓    ▓        ▓
▓   ▓▓▓▓▓▓    ▓▓▓▓▓    ▓
▓                      ▓
▓   ▓▓▓▓▓▓▓            ▓
▓                      ▓
▓▓▓▓▓▓▓▓▓▓▓▓▓▓▓▓▓▓▓▓▓▓▓▓